Gawader	Hoshab
Hoshab	Panjgur
Panjgur	Nag
Nag	Basima
Basima	Surab
Surab	Kalat
Kalat	Mastung
Mastung	Lakpass
Lakpass	Quetta
Quetta	QillaSaifullah
QillaSaifullah	Zhob
Zhob	DIKhan
DIKhan	Burhan
Burhan	Haripur
Haripur	Abbottabad
Abbottabad	Mansehra
Mansehra	Shinkiari
Shinkiari	Thakot
Thakot	Sazin
Sazin	Raikot
Raikot	Gilgit
Gilgit	Khunjerab
Basima	Rango
Rango	Khuzdar
Khuzdar	Shahdadkot
Shahdadkot	Ratodero
Ratodero	Shikarpur
Shikarpur	Sukkur
Shahdadkot	DeraAllahyarKhan
DeraAllahyarKhan	DGKhan
DGKhan	DaryaKhan
DaryaKhan	DIKhan
Gawader	Karachi
Karachi	Hyderabad
Hyderabad	Sukkur
Sukkur	Multan
Multan	Khanewal
Khanewal	AbdulHakeem
AbdulHakeem	Faisalabad
Faisalabad	Burhan
Burhan	Peshawar
AbdulHakeem	Lahore
Lahore	Burhan
Faisalabad	Lahore
